 WW_p_WW
WWW___WWWWWWWWWWWWWWWWWWWWWWWWWWWWWWWWWWWWWWWWWWW
W______WW_______wr__WW__0___WW________mr________W
W_w____WW___wr______WW______WW________mr___s____W
W___wm_WWW__WWWWW___WWMMWWrrWWm_WWW___mr________W
W__m________WW  WWWWW___WW__WW__WWWWWWWWWWWWWrrrW
W____r_____WWWWWWWWWW__WW__WW___WWW__m________r_W
 WW__WWWW__WW____M_____WW___m___WWW_____________W
 WW_WW  W__WW____s_____WW__M___WWWW______s__r___W
 WW__W  W__WW__WWWWWWWWWWWWWWWWWWWW_____MeM_____W
 WW__WWWW________WWW____WWWW____WWW______s______W
WM____mWW_W____wwWW______WWrr____WW_____________W
W__w___WW_mWWWWwwWWMMWWMMWW__WW__WW__m___r______W
W_r_wr_WW__WWWWWWWW__WW__WW__WW__WW_________m___W
W__w___WW______Wm____WWW_____WW____rr___________W
W1____wWW___Wm_____r_WWW__s__WW____r____________W
WWWWWWWWWWWWWWWWWWWWWWWWWWWWWWWWWWWWWWWWWWWWWWWWW
