WWWWWWWWWWWWWWWWWWWWWWWWWWWWWWWWWWWWWWWWWWWWWWWW
W__WWW________________WWW________WWWW_________WW
W__WWW________________WWW________WWWW_________WW
W__WWW__WWWWWWWWWWWW__WWWWWWWWW__WWWW__WWWWW__WW
W__WWW__WWW______WWW___WWWWWWWW__WWWW__WWWWW__WW
W__WWW__WWW____________WWWWWWWW__WWWW__WWWWW__WW
W__WWW__WWW__WWW__WWW__WWW________WWW__WWWWW__W
W__WWW__WWW__WWW__WWW__WWW________WWW__WWWWW__W
W__WWW__WWW____WWWWWWWWWWWWWWWW__WWWW__WWWWW__WW
W__WWW__WWW____WWWWWWWWWWWWWWWW__WWWW__WWWWW__WW
W__WWW__WWWWW____WWWWWWWWWWWWWW__WWWW__WWWWW__WW
W_________WWWWW________________________WWWWWW__W
W_________WWWWW________________________WWWWW__WW
WWWWWWWWWWWWWWWWWWWWWWWWWWWWWWWWWWWWWWWWWWWWWWWW