WWWWWWWWWWWWWWWWWWWWWWWWWWWWWWWWWWWWWWWWWWWWWWWWW
_p__WWWW_____m______m__WWW________WWWWMMM______WW
____WWW________________WWW________WWWWMMM______WW
WW__WWW__WWWWWWWWWWWW__WWWWWWWWW__WWWW__WWWWW__WW
WW__WWW__WWW______WWW___WWWWWWWW__WWWW__WWWWW__WW
WW__WWW__WWW____________WWWWWWWW__WWWW__WWWWW__WW
WW__WWW__WWW__WWWwwWWW__WWW___m____WWW__WWWWW__WW
WW__WWW__WWW__WWWwwWWW__WWW________WWW__WWWWW__WW
WW__WWW__WWW____WWWWWWWWWWWWWWWW__WWWW__WWWWW__WW
WW__WWW__WWW____WWWWWWWWWWWWWWWW__WWWW__WWWWW__WW
WW__WWW__WWWWW____WWWWWWWWWWWWWW__WWWW__WWWWW__WW
WW__m______WWWWW____W____mW___m_________WWWW_____
WW___m_____WWWWW_______Wm____mW__________WWWWW__g
WWWWWWWWWWWWWWWWWWWWWWWWWWWWWWWWWWWWWWWWWWWWWWWWW