WWWWWWWWWWWWWWWWWWWWWWWWWWWWWWWWWWWWWWWWWWWWWWWWW
_p__WWW______m_W____m__WWW________WWWWMMM______WW
____WWW____W_____W_____WWW________WWWWMMM______WW
WW_wWWW_rWWWWWWWWWWWW__WWWWWWWWW__WWWW__WWWWW__WW
WW_rWWW_wWWW____wwWWW___WWWWWWWW__WWWW__WWWWW__WW
WW__WWWr_WWW___m________WWWWWWWW__WWWW__WWWWW__WW
WWw_WWWw_WWW__WWWwwWWW__WWW___m____WWW__WWWWW__WW
WWr_WWW__WWW__WWWwwWWW__WWW________WWW__WWWWW__WW
WW_wWWW_rWWW____WWWWWWWWWWWWWWWW__WWWW__WWWWW__WW
WW_rWWW_WWWW_m__WWWWWWWWWWWWWWWW__WWWW__WWWWW__WW
WW__WWWr_WWWWW____WWWWWWWWWWWWWW__WWWW__WWWWW__WW
WW__m______WWWWW____W____mW___m_____r___WWWW_____
WW___m_____WWWWW_______Wm____mW__________WWWWW__e
WWWWWWWWWWWWWWWWWWWWWWWWWWWWWWWWWWWWWWWWWWWWWWWWW
