WWWWWWWWWWWWWWWWWWWWWWWWWWWWWWWWWWWWWWWWWWWWWWWW
p__WWW______m_________WWW________WWWW_________WW
___WWW________________WWW________WWWW_________WW
W__WWW__WWWWWWWWWWWW__WWWWWWWWW__WWWW__WWWWW__WW
W__WWW__WWW______WWW___WWWWWWWW__WWWW__WWWWW__WW
W__WWW__WWW____________WWWWWWWW__WWWW__WWWWW__WW
W__WWW__WWW__WWW__WWW__WWW___m____WWW__WWWWW__WW
W__WWW__WWW__WWW__WWW__WWW________WWW__WWWWW__WW
W__WWW__WWW____WWWWWWWWWWWWWWWW__WWWW__WWWWW__WW
W__WWW__WWW____WWWWWWWWWWWWWWWW__WWWW__WWWWW__WW
W__WWW__WWWWW____WWWWWWWWWWWWWW__WWWW__WWWWW__WW
W__m______WWWWW___m____________________WWWWW____
W___m_____WWWWW________________________WWWWW____
WWWWWWWWWWWWWWWWWWWWWWWWWWWWWWWWWWWWWWWWWWWWWWWW