 WW_p_WW
WWW___WWWWWWWWWWWWWWWWWWWWWWWWWWWWWWWWWWWWWWWWWWW
W______WW_______wr__WW__0___WW__________________W
W_w____WW___wr______WW______WW__________________W
W___wm_WWW__WWWWW___WW__WW__WW__WWW_____________W
W__m________WW  WWWWW___WW__WW__WWWWWWWWWWWWWWWWW
W____r_____WWWWWWWWWW__WW__WW___WWW_____________W
 WW__WWWW__WW____M_____WW___m___WWW_____________W
 WW_WW  W__WW__m___m___WW__M___WWWW_____________W
 WW__W  W__WW__WWWWWWWWWWWWWWWWWWWW_____________W
 WW__WWWW________WWW____WWWW____WWW_____________W
WM____mWW_W____wwWW______WW______WW_____________W
W__w___WW_mWWWWwwWW__WW__WW__WW__WW_____________W
W_r_wr_WW__WWWWWWWW__WW__WW__WW__WW_____________W
W__w___WW______Wm____WWW_____WW_________________W
W1____wWW___Wm_______WWW_____WW_________________W
WWWWWWWWWWWWWWWWWWWWWWWWWWWWWWWWWWWWWWWWWWWWWWWWW
