 WW_p_WW
WWW___WWWWWWWWWWWWWWWWWWWWWWWWWWWWWWWWWWWWWWWWWWW
W______WW_______wr__WW__c___WW___________________
W_w____WW___wr______WW______WW__________________e
W___wm_WWW__WWWWW___WW__WW__WW__W________________
W__m________WW  WWWWW___WW__WW__W
W____r_____WWWWWWWWWW__WW__WW___W
WWW__WWWW__WW____M_____WW_______W
WWW_WWWWW__WW__________WW__M___WW
WWW__WWWW__WW__WWWWWWWWWWWWWWWWWW
WWW__WWWW________WW______WW
WM____mWW_W____wwWW______WW
W__w___WW_mWWWWwwWW__WW
W_r_wr_WW__WWWWWWWW__WW
W__w__cWW______Wm____WW
Wc____wWW___Wm_______WW
WWWWWWWWWWWWWWWWWWWWWWW
