WWWWWWWWWWWWWWWWWWWWWWW_p_WWWWWWWWWWWWWWWWWWWWWWW
WWW_______WWWWWWWWWWWWW___WWWWWWWWWWWWWW______WWW
WW__m_________rm_________________W______r__m___WW
WW__r_________rm____________W_________m_r_m____WW
WW_____m__WWWWWWWWWWWWWWWWWWWWWWWWWWWWW________WW
WWWW____WWWWWWWWWWWWWWWWWWWWWWWWWWWWWWWWWW__WWWWW
WWWWW__WWWWWWWWWWWWWW_______WWWWWWWWWWWWWW__WWWWW
WWWWW__WWW_____WWWWW_________WWWWW_____WWW__WWWWW
WWWWW__Mr___0__WWWWW____e____WWWW__1___rM___WWWWW
WWWWW__Mr______WWWWW___sss___WWWW_______rM___WWWWW
WWWWW__WWW_____WWWWW_________WWWWW_____WWW__WWWWW
WWWWW__WWWWWWWWWWWWWWWrrrrrWWWWWWWWWWWWWWW__WWWWW
WWWW____WWWWWWWWWWWWWWWMMMWWWWWWWWWWWWWWWW__WWWWW
WW__m_____WWWWWWWWWWWWW___WWWWWWWWWWWWWW_______WW
WW_____w______www____________________M_________WW
WW__w__m______www___m________M____________m____WW
WW________WWWWWwwWWWWWWWWWWWWWWWWWWWWWWW_______WW
WWWWWWWWWWWWWWWwwWWWWWWWWWWWWWWWWWWWWWWWWWWWWWWWW
