WWWWWWWWWWWWWWWWWWWWWW_p_WWWWWWWWWWWWWWWWWWWWWWW
WW________WWWWWWWWWWWW___WWWWWWWWWWWWWW______WWW
WW___________________________________________WWW
WW___________________________________________WWW
WW________WWWWWWWWWWWWWWWWWWWWWWWWWWWWW______WWW
WWWWW__WWWWWWWWWWWWWWWWWWWWWWWWWWWWWWWWWW__WWWWW
WWWWW__WWWWWWWWWWWW_________WWWWWWWWWWWWW__WWWWW
WWWWW__WWWWWWWWWWWW_________WWWWWWWWWWWWW__WWWWW
WWWWW__WWWWWWWWWWWW_________WWWWWWWWWWWWW__WWWWW
WWWWW__WWWWWWWWWWWW_________WWWWWWWWWWWWW__WWWWW
WWWWW__WWWWWWWWWWWWWWW___WWWWWWWWWWWWWWWW__WWWWW
WWWWW__WWWWWWWWWWWWWWW___WWWWWWWWWWWWWWWW__WWWWW
WW________WWWWWWWWWWWW___WWWWWWWWWWWWWW_______WW
WW____________________________________________WW
WW____________________________________________WW
WW________WWWWWWWWWWWWWWWWWWWWWWWWWWWWW_______WW
WWWWWWWWWWWWWWWWWWWWWWWWWWWWWWWWWWWWWWWWWWWWWWWW