WWWWWWWWWWWWWWWWWWWWWWW_p_WWWWWWWWWWWWWWWWWWWWWWW
WWW_______WWWWWWWWWWWWW___WWWWWWWWWWWWWW______WWW
WW__m__________m_________________W_________m___WW
WW__________________________W_____________m____WW
WW_____m__WWWWWWWWWWWWWWWWWWWWWWWWWWWWW________WW
WWWW____WWWWWWWWWWWWWWWWWWWWWWWWWWWWWWWWWW__WWWWW
WWWWW__WWWWWWWWWWWWWW_______WWWWWWWWWWWWWW__WWWWW
WWWWW__WWW_____WWWWW_________WWWWW_____WWW__WWWWW
WWWWW__________WWWWW_________WWWW___________WWWWW
WWWWW__________WWWWW_________WWWW___________WWWWW
WWWWW__WWW_____WWWWW_________WWWWW_____WWW__WWWWW
WWWWW__WWWWWWWWWWWWWWW_____WWWWWWWWWWWWWWW__WWWWW
WWWW____WWWWWWWWWWWWWWW___WWWWWWWWWWWWWWWW__WWWWW
WW__m_____WWWWWWWWWWWWW___WWWWWWWWWWWWWW_______WW
WW_____w______www______________________________WW
WW__w__m______www___m_____________________m____WW
WW________WWWWWwwWWWWWWWWWWWWWWWWWWWWWWW_______WW
WWWWWWWWWWWWWWWwwWWWWWWWWWWWWWWWWWWWWWWWWWWWWWWWW