__WWWWWWWWWWWWWWWWWWWWWWW_p_WWWWWWWWWWWWWWWWWWWWWWW
WWW_______WWWWWWWWWWWWW___WWWWWWWWWWWWWW______WWW
WW__m______m__rM___m_____________W______r__m___WW
WW__r__s______rM___m____s___W_____m___M_r_M____WW
WW_____m__WWWWWWWWWWWWWWWWWWWWWWWWWWWWW________WW
WWWW____WWWWWWWWWWWWWWWWWWWWWWWWWWWWWWWWWWssWWWWW
WWWWWssWWWWWWWWWWWWWW_______WWWWWWWWWWWWWW__WWWWW
WWWWW__WWW_____WWWWW_________WWWWW_____WWW__WWWWW
WWWWW__Mr___0__WWWWW____e____WWWW__1___rM___WWWWW
WWWWW__Mr______WWWWW__sssss__WWWW_______rM___WWWWW
WWWWW__WWW_____WWWWW_________WWWWW_____WWW__WWWWW
WWWWW__WWWWWWWWWWWWWWWrrrrrWWWWWWWWWWWWWWW__WWWWW
WWWW____WWWWWWWWWWWWWWWMMMWWWWWWWWWWWWWWWW__WWWWW
WW__m_____WWWWWWWWWWWWW___WWWWWWWWWWWWWW_______WW
WW_____w______www_______M____________M_____M___WW
WW__w__m______www___m________M____________m____WW
WW________WWWWWwwWWWWWWWWWWWWWWWWWWWWWWW_______WW
WWWWWWWWWWWWWWWwwWWWWWWWWWWWWWWWWWWWWWWWWWWWWWWWW
