WWWWWWW             WWWWWWWWWWWWWWW             
WW____WW           WWWW_____mr___WWWW           
W__p___WW         WWWW___WWWWWW____WWWWW        
W______WW         WWW___WWWWWWWWW____WWWW       
WW____WWWW      WWWW______WWWWWWWW____WWWWWWWWWW
WWWW___WWWW   WWWWm___m____WWWWWWWW_____WWWWWWWW
WWWWW____WWWWWWWW___m_______WWWWWWWWW____WWWWWWW
 WWWWW_m__WWWWWWW_____m_____WWWWWWWWWWW____WWWWW
  WWWWW____WWWWWWW__m______WWWWWWWWWWWWW______WW
   WWWWWW____WWWWWW___m___WWWWWWWWWWWWW___mm___W
    WWWWWWW____WWWW_____WWWWWWWWWWWWWWW___mm___W
     WWWWWWWW___m____WWWWWWWWWWWWWWWWWW________W
       WWWWWWWWWWWWWWWWWWWWWWWWWWWWWWWWW______WW
         WWWWWWWWWWWWWWWWWWWWWWWWWWWWWWWWW_e_WWW
