WWWWWWWWWWWWWWWWWWWWWWWWWWWWWWWWWWWWWWWWWWWWWWWW
WW____WWWWWWWWWWWWWWWWW___________WWWWWWWWWWWWWW
W__p___WWWWWWWWWWWWWWW___WWWWWW____WWWWWWWWWWWWW
W______WWWWWWWWWWWWWW___WWWWWWWWW____WWWWWWWWWWW
WW____WWWWWWWWWWWWWW______WWWWWWWW____WWWWWWWWWW
WWWW____WWWWWWWWWW_________WWWWWWWW_____WWWWWWWW
WWWWW____WWWWWWWW___m_______WWWWWWWWW____WWWWWWW
WWWWWW_m__WWWWWWW_____m_____WWWWWWWWWWW____WWWWW
WWWWWWW____WWWWWWW_________WWWWWWWWWWWWW______WW
WWWWWWWWW____WWWWWW___m___WWWWWWWWWWWWWW______WW
WWWWWWWWWWW____WWWW______WWWWWWWWWWWWWWW______WW
WWWWWWWWWWWWW________WWWWWWWWWWWWWWWWWWW______WW
WWWWWWWWWWWWWWWWWWWWWWWWWWWWWWWWWWWWWWWW______WW
WWWWWWWWWWWWWWWWWWWWWWWWWWWWWWWWWWWWWWWWWWWWWWWW
