WWWWWWWWWWWWWWWWWWWWWWWWWWWWWWWWWWWWWWWWWWWWWWWW
WW____WWWWWWWWWWWWWWWWW_____mr____WWWWWWWWWWWWWW
W__p___WWWWWWWWWWWWWWW___WWWWWW____WWWWWWWWWWWWW
W______WWWWWWWWWWWWWW___WWWWWWWWW____WWWWWWWWWWW
WW____WWWWWWWWWWWWWW______WWWWWWWW____WWWWWWWWWW
WWWW____WWWWWWWWWW____c____WWWWWWWW_____WWWWWWWW
WWWWW____WWWWWWWW___m___m___WWWWWWWWW____WWWWWWW
WWWWWW_m__WWWWWWW_____m_____WWWWWWWWWWW____WWWWW
WWWWWWW____WWWWWWW_________WWWWWWWWWWWWW______WW
WWWWWWWWW____WWWWWW___m___WWWWWWWWWWWWWW__mm__WW
WWWWWWWWWWW____WWWW______WWWWWWWWWWWWWWW__mm__WW
WWWWWWWWWWWWW___m____WWWWWWWWWWWWWWWWWWW______WW
WWWWWWWWWWWWWWWWWWWWWWWWWWWWWWWWWWWWWWWW_____eWW
WWWWWWWWWWWWWWWWWWWWWWWWWWWWWWWWWWWWWWWWWWWWWWWW
