WWWWWWWWWW
Wp___WwwwW
W____W___W
W_______MW
WWWW_WWWWW
Wr___m___W
WWWWWW_WWW
W___W____W
W________W
WWWWWWWWWW