WWWWWWWWWWWWWWWWWW
Wp_____mcW_m_Mm_W
W____w_MmW__m_m__W
W_______rW__WW__WWWWWWWWWWWWW
W__wm_WWWWr_W______mr___rW
W_m_r___Mm_WM_________mr_W
W__r__w__m_WWWWW__m__w_r__W
W____mm___W__McWmrw__mrw__W
 Wr____w__r___MrW___m_rw_M_W
 WMr____mm_____Wrrr__r____eW
  WWWWWWWWWWWWWWWWWWWWWWWWWW