WWWWWWWWWWWWWWWWWWWWWWWWWWWWWWWWWWWWWWWWWWWWWWWW
WW________WWWWWWWWWW___________WWWWWWWWWWWWWWWWW
W___WWWW_____WWWWWWW____wwww____WWWWWWWWWWWWWWWWWWW
W___WWWWW______WWWWWW__wwwwwww__WWWWWWWWWWWWWWWWWWWW
W___WWWWWWW_____WWWWW________WWWWWWWWWWWWWWWWWWWWWW
W___WWWWWWWW____WWWWWWW____WWWWWWWWWWWWWWWWWWWWWW
W___WWWWWWWWWW___WWWWW___WWWWWWWWWWWWWWWWWWWWWW
W___WWWWWWWWWWW_____________WWWWWWWWWWWWWWWWWWW
W___WWWWWWWWWWWW______________WWWWWWWWWWWWWWWWWWWW
W____WWWWWWWWWWWWWW________WWWWWWWWWWWWWWWWWWWW
WWW______WWWWWWWWWWW_________WWWWWWWWWWWWWWWWWW
WWWWWW____WWWWWWWWWWWWWWWWWWWWWWWWWWWWWWWWWWWWWW
WWWWWWW____WWWWWWWWWWWWWWWWWWWWWWWWWWWWWWWWWWWWWW
WWWWWWW_____WWWWWWWWWWWWWWWWWWWWWWWWWWWWWWWWWWWWW
WWWWWW_______WWWWWWWWWWWWWWWWWWWWWWWWWWWWWWWWWWW