WWWWWWWWWWWWWWWWWWWWWWWWWWWWWWWWWWWWWWWWWWWWWWWWWWW
WWWWWWWWWW___________WWWWWWWWWW_____WWWWWWWWWWWWWWW
WWWWWWWWW_c_______W___WWWWWW_____m_____WWWWWWWWWWWW
WWWWWWWWWW_c____WWWW___WWWWW____WWW____WWWWWWWWWWWW
WWWWWWWWWWWWW___WWWWW___WWWW____WWW____WWWWWWWWWWWW
WWWWWWWWWWWWWWWWWWWWWW___WWW____WWW____WWWWWWWWWWWW
WW_______MWWWWWWWWWWW__________WWWWWWW____WWWWWWWWW
W___WWWWr___rWWWWWWW____________WWWWWWW____WWWWWWWW
WrrrWWWWW______WWWWWW_r__r__r__WWWWWWWWWW____WWWWWW
W___WWWWWWW_____WWWWW________WWWWWWWWWWWWWW____WWWW
W___WWWWWWWW__M_WWWWWWW_M__WWWWWWWWWWWWWw__m_____WW
W___WWWWWWWWWW___WWWWW___WWWWWWWWWWWWWWW__________W
WmmmWWWWWWWWWWW_____________WWWWWWWWWWW______m____W
W___WWWWWWWWWWWW__M_____r_____WWWWWWWW____m_______W
W____WWWWWWWWWWWWWW________WWWWWWWWWWWW_______m___W
WWW___m__WWWWWWWWWWW__M______WWWWWWWWWWW__________W
WWWWWW___m_WWWWWWWWWWWWWWWWWWWWWWWWWWWWWW____M__M_W
WWWWWWW____WWWWWWWWWWWWWWWWWWWWWWWWWWWWWWWWW_____WW
WWWWWWW_____WWWWWWWWWWWWWWWWWWWWWWWWWWWWWWWWW___WWW
WWWWWW___p___WWWWWWWWWWWWWWWWWWWWWWWWWWWWWWWW_e_WWW
