WWWWWWWWWWWWWWWWWWWWWWWWWWWWWWWWWWWWWWWWWWWWWWWW
WW_______MWWWWWWWWWW_____e_____WWWWWWWWWWWWWWWWW
W___WWWWr___rWWWWWWW____________WWWWWWWWWWWWWWWWWWW
WrrrWWWWW______WWWWWW_r__r__r__WWWWWWWWWWWWWWWWWWWW
W___WWWWWWW_____WWWWW________WWWWWWWWWWWWWWWWWWWWWW
W___WWWWWWWW__M_WWWWWWW_M__WWWWWWWWWWWWWWWWWWWWWW
W___WWWWWWWWWW___WWWWW___WWWWWWWWWWWWWWWWWWWWWW
WmmmWWWWWWWWWWW_____________WWWWWWWWWWWWWWWWWWW
W___WWWWWWWWWWWW__M_____r_____WWWWWWWWWWWWWWWWWWWW
W____WWWWWWWWWWWWWW________WWWWWWWWWWWWWWWWWWWW
WWW___m__WWWWWWWWWWW__M______WWWWWWWWWWWWWWWWWW
WWWWWW___m_WWWWWWWWWWWWWWWWWWWWWWWWWWWWWWWWWWWWWW
WWWWWWW____WWWWWWWWWWWWWWWWWWWWWWWWWWWWWWWWWWWWWW
WWWWWWW_____WWWWWWWWWWWWWWWWWWWWWWWWWWWWWWWWWWWWW
WWWWWW___p___WWWWWWWWWWWWWWWWWWWWWWWWWWWWWWWWWWW
