WWWWWWWWWW
Wp_______W
W________W
W________W
W________W
W____s___W
W________W
W________W
W________W
WWWWWWWWWW